5	7
x	2	2	2	2   2    1
x	1	x	x	x   1p   x
x	1	1	1	1   1    x
x	1	x	x	x   1r   x
x	2	x	x	x   1b   x