5	7
x	2	2	2	2   2	1p
x	1	x	x	x   1b	x
x	1	1	1	1   1r	x
x	1b	x	x	x   1	x
x	2p	x	x	x   1	x